"","Date/Time","Pedestrians","Towards_Manhattan","Towards_Brooklyn","Weather","Temp","Events"
"1","2/5/18 4:00",0,0,0,"clear-night",36,""
"2","10/25/17 16:00",2241,1201,1040,"partly-cloudy-day",64,""
"3","12/1/17 4:00",3,2,1,"partly-cloudy-night",45,""
"4","2/4/18 23:00",6,5,1,"rain",40,""
"5","1/11/18 22:00",76,40,36,"clear-night",44,""
"6","12/30/17 3:00",0,0,0,"clear-night",16,""
"7","10/27/17 21:00",225,99,126,"clear-night",54,""
"8","11/7/17 4:00",2,1,1,"clear-night",42,""
"9","10/3/17 21:00",196,102,94,"clear-night",58,""
"10","12/31/17 15:00",1724,915,809,"partly-cloudy-day",14,"New Year's Eve"
"11","2/3/18 21:00",74,50,24,"clear-night",28,""
"12","11/25/17 2:00",17,3,14,"clear-night",38,""
"13","12/9/17 9:00",480,266,214,"partly-cloudy-day",34,""
"14","11/13/17 4:00",9,5,4,"partly-cloudy-night",41,""
"15","1/26/18 14:00",966,455,511,"clear-day",35,""
"16","1/18/18 14:00",714,341,373,"clear-day",31,""
"17","12/6/17 2:00",4,0,4,"partly-cloudy-night",56,""
"18","12/2/17 13:00",2649,1152,1497,"clear-day",47,""
"19","1/11/18 4:00",2,0,2,"partly-cloudy-night",37,""
"20","11/3/17 17:00",2281,1232,1049,"partly-cloudy-day",72,""
"21","12/18/17 7:00",129,63,66,"partly-cloudy-night",34,""
"22","11/25/17 17:00",1779,667,1112,"clear-night",54,""
"23","12/11/17 14:00",1674,792,882,"partly-cloudy-day",40,""
"24","12/27/17 6:00",61,35,26,"cloudy",19,""
"25","11/28/17 19:00",361,237,124,"clear-night",49,""
"26","10/27/17 5:00",22,13,9,"clear-night",45,""
"27","1/17/18 20:00",59,38,21,"clear-night",25,""
"28","11/12/17 16:00",2085,786,1299,"clear-day",45,""
"29","12/1/17 5:00",23,15,8,"clear-night",44,""
"30","10/16/17 5:00",18,12,6,"partly-cloudy-night",61,""
"31","1/23/18 8:00",103,30,73,"rain",45,""
"32","11/27/17 1:00",17,9,8,"clear-night",38,""
"33","10/6/17 18:00",1470,834,636,"clear-day",74,""
"34","1/29/18 9:00",307,136,171,"clear-day",40,""
"35","12/15/17 23:00",38,29,9,"clear-night",22,""
"36","11/19/17 14:00",2069,895,1174,"partly-cloudy-day",49,""
"37","11/18/17 16:00",986,422,564,"partly-cloudy-day",49,""
"38","1/4/18 15:00",199,123,76,"snow",22,""
"39","1/5/18 2:00",0,0,0,"clear-night",15,""
"40","11/1/17 16:00",1814,894,920,"partly-cloudy-day",56,""
"41","1/6/18 13:00",652,341,311,"clear-day",12,""
"42","10/5/17 5:00",19,12,7,"partly-cloudy-night",63,""
"43","1/6/18 8:00",39,16,23,"clear-day",7,""
"44","2/3/18 8:00",125,62,63,"clear-day",18,""
"45","12/27/17 21:00",69,28,41,"clear-night",18,""
"46","12/28/17 19:00",236,123,113,"clear-night",15,""
"47","11/30/17 14:00",1278,543,735,"partly-cloudy-day",48,""
"48","12/24/17 15:00",2616,1445,1171,"clear-day",39,"Christmas Eve"
"49","12/8/17 1:00",9,6,3,"clear-night",37,""
"50","1/24/18 18:00",404,271,133,"clear-night",33,""
"51","12/26/17 8:00",208,88,120,"clear-day",24,""
"52","12/13/17 15:00",966,439,527,"clear-day",30,""
"53","12/23/17 3:00",3,0,3,"partly-cloudy-night",39,""
"54","1/3/18 7:00",111,56,55,"clear-night",13,""
"55","10/20/17 23:00",180,73,107,"clear-night",60,""
"56","12/4/17 23:00",40,14,26,"partly-cloudy-night",48,""
"57","11/16/17 1:00",9,5,4,"partly-cloudy-night",50,""
"58","10/15/17 11:00",1949,1130,819,"partly-cloudy-day",68,""
"59","12/12/17 1:00",19,6,13,"partly-cloudy-night",37,""
"60","1/9/18 12:00",841,437,404,"clear-day",42,""
"61","1/28/18 20:00",236,150,86,"partly-cloudy-night",46,""
"62","11/21/17 13:00",1855,802,1053,"clear-day",56,""
"63","11/5/17 6:00",148,125,23,"partly-cloudy-night",53,"Daylight Saving Time ends"
"64","11/7/17 21:00",6,6,0,"rain",40,""
"65","1/30/18 17:00",432,251,181,"partly-cloudy-day",32,""
"66","10/14/17 21:00",393,162,231,"cloudy",67,""
"67","10/27/17 4:00",4,3,1,"clear-night",42,""
"68","11/12/17 23:00",43,14,29,"clear-night",39,""
"69","10/11/17 9:00",535,244,291,"clear-day",65,""
"70","1/11/18 15:00",1219,595,624,"partly-cloudy-day",47,""
"71","12/19/17 3:00",6,0,6,"cloudy",44,""
"72","11/7/17 5:00",27,14,13,"clear-night",41,""
"73","12/16/17 16:00",1432,632,800,"cloudy",37,""
"74","11/24/17 19:00",539,258,281,"clear-night",44,"Black Friday"
"75","1/25/18 3:00",2,1,1,"clear-night",23,""
"76","1/17/18 3:00",0,0,0,"partly-cloudy-night",35,""
"77","10/22/17 14:00",3093,1510,1583,"clear-day",65,""
"78","12/17/17 2:00",12,6,6,"partly-cloudy-night",33,""
"79","1/13/18 3:00",8,5,3,"cloudy",55,""
"80","1/10/18 3:00",3,2,1,"clear-night",27,""
"81","1/12/18 8:00",116,41,75,"cloudy",55,""
"82","11/15/17 3:00",4,2,2,"partly-cloudy-night",36,""
"83","11/10/17 2:00",5,4,1,"clear-night",48,"Veterans Day observed"
"84","12/22/17 14:00",1772,824,948,"partly-cloudy-day",45,""
"85","10/20/17 12:00",2098,1012,1086,"clear-day",69,""
"86","1/15/18 15:00",889,448,441,"partly-cloudy-day",30,"Martin Luther King Jr. Day"
"87","10/10/17 18:00",1535,933,602,"clear-day",78,""
"88","1/15/18 0:00",8,4,4,"clear-night",17,"Martin Luther King Jr. Day"
"89","11/9/17 5:00",19,10,9,"clear-night",38,""
"90","10/1/17 0:00",44,30,14,"clear-night",52,""
"91","11/19/17 3:00",3,1,2,"partly-cloudy-night",55,""
"92","1/6/18 3:00",1,0,1,"clear-night",9,""
"93","11/2/17 9:00",579,325,254,"partly-cloudy-day",60,""
"94","10/24/17 3:00",5,2,3,"partly-cloudy-night",68,""
"95","10/28/17 18:00",1534,589,945,"clear-night",64,""
"96","12/15/17 18:00",155,103,52,"partly-cloudy-night",23,""
"97","11/23/17 23:00",45,29,16,"clear-night",34,"Thanksgiving Day"
"98","12/21/17 12:00",1361,561,800,"clear-day",37,""
"99","12/21/17 6:00",51,28,23,"clear-night",31,""
"100","10/4/17 16:00",1733,964,769,"clear-day",74,""
"101","12/4/17 13:00",1781,766,1015,"clear-day",49,""
"102","1/4/18 0:00",41,38,3,"partly-cloudy-night",26,""
"103","12/4/17 18:00",800,461,339,"clear-night",46,""
"104","11/16/17 6:00",32,17,15,"partly-cloudy-night",50,""
"105","12/10/17 6:00",20,15,5,"clear-night",28,""
"106","10/21/17 1:00",29,16,13,"clear-night",57,""
"107","10/15/17 16:00",2824,1280,1544,"partly-cloudy-day",71,""
"108","1/2/18 18:00",589,286,303,"clear-night",23,""
"109","1/7/18 11:00",432,250,182,"clear-day",11,""
"110","12/17/17 7:00",92,48,44,"partly-cloudy-night",32,""
"111","11/20/17 0:00",28,6,22,"partly-cloudy-night",39,""
"112","12/26/17 13:00",2031,936,1095,"clear-day",26,""
"113","12/12/17 22:00",84,65,19,"partly-cloudy-night",33,""
"114","10/18/17 0:00",23,11,12,"clear-night",49,""
"115","11/10/17 17:00",638,263,375,"clear-night",31,"Veterans Day observed"
"116","10/8/17 2:00",46,25,21,"partly-cloudy-night",72,""
"117","11/20/17 11:00",1252,606,646,"partly-cloudy-day",42,""
"118","10/22/17 19:00",739,249,490,"clear-night",61,""
"119","11/18/17 6:00",28,20,8,"clear-night",31,""
"120","1/5/18 5:00",4,2,2,"clear-night",11,""
"121","1/13/18 16:00",1674,763,911,"clear-day",30,""
"122","10/25/17 6:00",104,66,38,"clear-night",59,""
"123","2/2/18 0:00",6,4,2,"partly-cloudy-night",38,""
"124","11/1/17 18:00",834,442,392,"partly-cloudy-night",56,""
"125","12/20/17 4:00",4,3,1,"partly-cloudy-night",47,""
"126","11/11/17 21:00",156,74,82,"clear-night",32,"Veterans Day"
"127","1/1/18 2:00",16,7,9,"clear-night",8,"New Year's Day"
"128","12/28/17 5:00",6,3,3,"clear-night",14,""
"129","1/31/18 12:00",694,351,343,"clear-day",26,""
"130","12/6/17 12:00",1166,444,722,"clear-day",41,""
"131","11/28/17 14:00",1167,451,716,"clear-day",50,""
"132","10/5/17 19:00",635,250,385,"clear-night",77,""
"133","12/27/17 16:00",2701,1375,1326,"clear-day",23,""
"134","10/29/17 11:00",640,302,338,"partly-cloudy-day",61,""
"135","10/31/17 10:00",1667,945,722,"clear-day",51,"Halloween"
"136","11/23/17 18:00",512,233,279,"clear-night",38,"Thanksgiving Day"
"137","12/18/17 10:00",768,418,350,"cloudy",37,""
"138","10/10/17 1:00",13,7,6,"partly-cloudy-night",73,""
"139","10/12/17 12:00",1663,842,821,"partly-cloudy-day",59,""
"140","1/1/18 23:00",56,18,38,"clear-night",15,"New Year's Day"
"141","1/18/18 6:00",32,14,18,"clear-night",18,""
"142","11/14/17 12:00",1079,462,617,"partly-cloudy-day",43,""
"143","1/26/18 0:00",39,28,11,"partly-cloudy-night",28,""
"144","12/3/17 10:00",1238,603,635,"partly-cloudy-day",44,""
"145","1/19/18 4:00",0,0,0,"clear-night",22,""
"146","1/12/18 23:00",45,32,13,"rain",56,""
"147","1/8/18 5:00",4,2,2,"partly-cloudy-night",18,""
"148","1/8/18 19:00",192,146,46,"cloudy",29,""
"149","1/30/18 4:00",0,0,0,"partly-cloudy-night",30,""
"150","12/25/17 22:00",75,27,48,"clear-night",28,"Christmas Day"
"151","11/30/17 3:00",1,0,1,"clear-night",36,""
"152","1/24/18 16:00",845,422,423,"partly-cloudy-day",36,""
"153","12/15/17 8:00",159,51,108,"clear-day",21,""
"154","1/19/18 19:00",176,105,71,"clear-night",34,""
"155","12/7/17 10:00",890,494,396,"clear-day",41,""
"156","11/11/17 10:00",953,494,459,"clear-day",30,"Veterans Day"
"157","1/14/18 7:00",44,24,20,"clear-night",15,""
"158","2/4/18 16:00",475,217,258,"partly-cloudy-day",39,""
"159","2/1/18 1:00",2,0,2,"partly-cloudy-night",31,""
"160","1/16/18 22:00",35,18,17,"clear-night",34,""
"161","11/28/17 9:00",383,180,203,"clear-day",38,""
"162","11/29/17 6:00",78,46,32,"clear-night",46,""
"163","10/13/17 20:00",370,157,213,"partly-cloudy-night",62,""
"164","1/31/18 19:00",297,216,81,"clear-night",30,""
"165","12/5/17 9:00",337,138,199,"partly-cloudy-day",53,""
"166","12/20/17 19:00",256,154,102,"clear-night",37,""
"167","1/2/18 16:00",2294,1029,1265,"clear-day",25,""
"168","10/31/17 21:00",105,53,52,"clear-night",50,"Halloween"
"169","11/14/17 17:00",840,449,391,"partly-cloudy-night",43,""
"170","1/20/18 7:00",116,64,52,"clear-night",36,""
"171","12/4/17 8:00",389,146,243,"partly-cloudy-day",35,""
"172","1/20/18 12:00",1586,806,780,"clear-day",49,""
"173","12/23/17 22:00",72,35,37,"partly-cloudy-night",44,""
"174","10/1/17 5:00",16,12,4,"partly-cloudy-night",50,""
"175","12/12/17 0:00",27,16,11,"partly-cloudy-night",37,""
"176","11/6/17 9:00",503,261,242,"cloudy",62,""
"177","2/3/18 12:00",1191,579,612,"partly-cloudy-day",26,""
"178","11/20/17 5:00",15,9,6,"partly-cloudy-night",37,""
"179","10/19/17 17:00",2101,1227,874,"clear-day",69,""
"180","10/6/17 0:00",50,21,29,"partly-cloudy-night",70,""
"181","12/27/17 11:00",1793,945,848,"clear-day",21,""
"182","1/4/18 2:00",6,1,5,"partly-cloudy-night",26,""
"183","10/11/17 7:00",277,142,135,"clear-night",64,""
"184","12/6/17 7:00",160,63,97,"cloudy",46,""
"185","12/28/17 2:00",2,1,1,"clear-night",15,""
"186","1/27/18 5:00",2,2,0,"clear-night",32,""
"187","11/17/17 14:00",1583,686,897,"clear-day",47,""
"188","10/16/17 19:00",429,171,258,"clear-night",54,""
"189","11/22/17 21:00",95,46,49,"clear-night",38,""
"190","11/6/17 14:00",1587,714,873,"partly-cloudy-day",65,""
"191","10/19/17 8:00",402,129,273,"clear-day",55,""
"192","10/28/17 7:00",272,148,124,"clear-night",48,""
"193","10/22/17 7:00",213,133,80,"clear-night",54,""
"194","1/8/18 4:00",14,7,7,"cloudy",18,""
"195","12/22/17 3:00",2,0,2,"clear-night",34,""
"196","12/14/17 17:00",405,212,193,"clear-night",28,""
"197","1/27/18 22:00",141,76,65,"partly-cloudy-night",51,""
"198","12/3/17 21:00",271,150,121,"clear-night",41,""
"199","10/26/17 14:00",1791,814,977,"partly-cloudy-day",55,""
"200","12/10/17 12:00",2043,907,1136,"clear-day",37,""
"201","10/12/17 5:00",7,6,1,"partly-cloudy-night",58,""
"202","10/29/17 5:00",1,0,1,"partly-cloudy-night",60,""
"203","11/24/17 9:00",497,304,193,"clear-day",37,"Black Friday"
"204","10/9/17 10:00",888,446,442,"partly-cloudy-day",72,"Columbus Day (regional holiday)"
"205","10/25/17 21:00",188,90,98,"clear-night",59,""
"206","11/29/17 21:00",168,131,37,"clear-night",46,""
"207","11/13/17 9:00",197,104,93,"partly-cloudy-day",41,""
"208","11/5/17 21:00",111,57,54,"partly-cloudy-night",60,"Daylight Saving Time ends"
"209","11/18/17 21:00",143,99,44,"partly-cloudy-night",48,""
"210","12/1/17 22:00",144,98,46,"clear-night",40,""
"211","12/2/17 9:00",754,418,336,"clear-day",38,""
"212","10/1/17 10:00",2478,1906,572,"clear-day",57,""
"213","12/31/17 11:00",1493,825,668,"clear-day",15,"New Year's Eve"
"214","12/11/17 1:00",9,6,3,"cloudy",34,""
"215","2/3/18 17:00",1176,504,672,"clear-day",30,""
"216","11/14/17 22:00",138,94,44,"partly-cloudy-night",38,""
"217","12/14/17 12:00",815,359,456,"partly-cloudy-day",30,""
"218","11/29/17 10:00",629,366,263,"partly-cloudy-day",52,""
"219","12/9/17 15:00",652,364,288,"fog",31,""
"220","12/7/17 0:00",26,15,11,"partly-cloudy-night",38,""
"221","10/17/17 1:00",7,3,4,"clear-night",46,""
"222","10/17/17 0:00",31,16,15,"clear-night",47,""
"223","10/3/17 8:00",390,162,228,"clear-day",52,""
"224","12/8/17 23:00",77,54,23,"partly-cloudy-night",35,""
"225","11/17/17 9:00",503,275,228,"clear-day",41,""
"226","1/17/18 15:00",376,201,175,"partly-cloudy-day",33,""
"227","1/20/18 22:00",124,55,69,"clear-night",40,""
"228","12/13/17 4:00",1,0,1,"clear-night",21,""
"229","11/24/17 14:00",2344,1030,1314,"clear-day",50,"Black Friday"
"230","10/23/17 5:00",24,14,10,"partly-cloudy-night",59,""
"231","2/3/18 4:00",0,0,0,"clear-night",16,""
"232","12/24/17 19:00",421,167,254,"partly-cloudy-night",38,"Christmas Eve"
"233","10/23/17 22:00",127,58,69,"clear-night",69,""
"234","10/6/17 22:00",238,100,138,"clear-night",69,""
"235","1/23/18 4:00",5,2,3,"fog",40,""
"236","1/30/18 14:00",510,252,258,"rain",35,""
"237","2/4/18 20:00",11,10,1,"rain",42,""
"238","12/12/17 7:00",140,59,81,"partly-cloudy-night",44,""
"239","12/17/17 19:00",455,276,179,"clear-night",35,""
"240","10/21/17 20:00",514,245,269,"clear-night",61,""
"241","12/31/17 0:00",12,2,10,"clear-night",19,"New Year's Eve"
"242","11/18/17 12:00",1910,871,1039,"clear-day",46,""
"243","12/23/17 7:00",39,13,26,"cloudy",39,""
"244","11/3/17 5:00",21,17,4,"partly-cloudy-night",61,""
"245","1/5/18 12:00",749,361,388,"clear-day",13,""
"246","10/30/17 19:00",409,178,231,"clear-night",52,""
"247","1/11/18 0:00",12,7,5,"partly-cloudy-night",36,""
"248","1/31/18 5:00",11,4,7,"clear-night",19,""
"249","11/23/17 3:00",5,3,2,"clear-night",32,"Thanksgiving Day"
"250","12/29/17 5:00",2,0,2,"partly-cloudy-night",11,""
"251","1/10/18 10:00",412,245,167,"clear-day",33,""
"252","12/18/17 0:00",42,16,26,"partly-cloudy-night",34,""
"253","1/22/18 0:00",9,4,5,"cloudy",44,""
"254","10/20/17 16:00",2213,1207,1006,"clear-day",73,""
"255","11/21/17 9:00",535,280,255,"clear-day",46,""
"256","11/3/17 22:00",114,60,54,"clear-night",55,""
"257","11/25/17 7:00",147,69,78,"clear-day",35,""
"258","1/12/18 4:00",3,2,1,"partly-cloudy-night",45,""
"259","1/18/18 11:00",541,277,264,"clear-day",27,""
"260","12/30/17 8:00",134,67,67,"partly-cloudy-day",18,""
"261","11/22/17 12:00",1043,514,529,"partly-cloudy-day",50,""
"262","10/30/17 2:00",10,2,8,"partly-cloudy-night",58,""
"263","12/19/17 23:00",150,121,29,"clear-night",48,""
"264","12/22/17 20:00",233,107,126,"partly-cloudy-night",43,""
"265","1/11/18 11:00",755,346,409,"partly-cloudy-day",43,""
"266","12/13/17 9:00",250,97,153,"partly-cloudy-day",22,""
"267","11/25/17 22:00",287,130,157,"partly-cloudy-night",49,""
"268","11/1/17 3:00",0,0,0,"clear-night",44,""
"269","11/8/17 1:00",4,3,1,"partly-cloudy-night",39,""
"270","12/8/17 8:00",295,98,197,"clear-day",33,""
"271","1/16/18 12:00",527,251,276,"partly-cloudy-day",33,""
"272","1/29/18 21:00",89,50,39,"partly-cloudy-night",39,""
"273","11/9/17 9:00",469,251,218,"partly-cloudy-day",43,""
"274","11/14/17 7:00",169,74,95,"clear-day",34,""
"275","12/21/17 10:00",752,417,335,"clear-day",35,""
"276","1/27/18 12:00",1821,885,936,"clear-day",46,""
"277","10/15/17 4:00",9,6,3,"partly-cloudy-night",65,""
"278","12/25/17 2:00",9,6,3,"cloudy",36,"Christmas Day"
"279","10/23/17 10:00",1224,684,540,"partly-cloudy-day",66,""
"280","11/26/17 10:00",1080,591,489,"partly-cloudy-day",45,""
"281","10/7/17 9:00",989,655,334,"partly-cloudy-day",68,""
"282","12/29/17 10:00",1020,622,398,"clear-day",15,""
"283","12/2/17 19:00",547,256,291,"clear-night",43,""
"284","11/20/17 22:00",86,48,38,"clear-night",41,""
"285","11/8/17 18:00",384,204,180,"partly-cloudy-night",46,""
"286","1/7/18 8:00",42,20,22,"clear-day",4,""
"287","11/30/17 18:00",480,305,175,"clear-night",46,""
"288","10/28/17 22:00",254,124,130,"partly-cloudy-night",61,""
"289","1/16/18 7:00",81,39,42,"cloudy",26,""
"290","11/4/17 13:00",3130,1525,1605,"clear-day",53,""
"291","10/8/17 6:00",41,24,17,"partly-cloudy-night",72,""
"292","11/15/17 15:00",1193,553,640,"partly-cloudy-day",48,""
"293","10/17/17 20:00",236,113,123,"clear-night",52,""
"294","11/19/17 20:00",255,107,148,"partly-cloudy-night",44,""
"295","12/12/17 18:00",420,297,123,"partly-cloudy-night",41,""
"296","11/7/17 10:00",1073,632,441,"clear-day",48,""
"297","10/8/17 17:00",2485,1241,1244,"clear-day",76,""
"298","12/16/17 11:00",1437,722,715,"partly-cloudy-day",32,""
"299","1/1/18 8:00",58,28,30,"clear-day",6,"New Year's Day"
"300","1/6/18 20:00",37,23,14,"clear-night",8,""
"301","11/11/17 17:00",1077,450,627,"clear-night",35,"Veterans Day"
"302","1/22/18 11:00",563,299,264,"partly-cloudy-day",45,""
"303","2/1/18 20:00",252,195,57,"partly-cloudy-night",40,""
"304","12/25/17 6:00",5,2,3,"partly-cloudy-night",34,"Christmas Day"
"305","1/10/18 8:00",181,48,133,"clear-day",25,""
"306","12/19/17 18:00",590,358,232,"clear-night",52,""
"307","1/12/18 19:00",77,51,26,"fog",57,""
"308","11/21/17 19:00",485,316,169,"clear-night",50,""
"309","11/16/17 23:00",63,46,17,"partly-cloudy-night",43,""
"310","1/24/18 3:00",1,0,1,"clear-night",40,""
"311","1/15/18 4:00",4,1,3,"partly-cloudy-night",17,"Martin Luther King Jr. Day"
"312","12/14/17 6:00",29,15,14,"partly-cloudy-night",25,""
"313","10/2/17 18:00",1659,1055,604,"clear-day",69,""
"314","2/2/18 9:00",205,98,107,"clear-day",27,""
"315","1/1/18 19:00",336,146,190,"clear-night",16,"New Year's Day"
"316","11/27/17 23:00",30,16,14,"clear-night",38,""
"317","12/5/17 16:00",696,335,361,"partly-cloudy-day",59,""
"318","11/2/17 14:00",2073,991,1082,"partly-cloudy-day",70,""
"319","11/30/17 1:00",10,4,6,"clear-night",39,""
"320","10/30/17 13:00",1914,960,954,"partly-cloudy-day",55,""
"321","12/24/17 4:00",0,0,0,"clear-night",38,"Christmas Eve"
"322","11/5/17 1:00",29,19,10,"partly-cloudy-night",52,"Daylight Saving Time ends"
"323","10/18/17 9:00",523,270,253,"clear-day",51,""
"324","10/2/17 0:00",60,20,40,"clear-night",53,""
"325","11/10/17 13:00",1113,522,591,"clear-day",35,"Veterans Day observed"
"326","11/6/17 21:00",100,51,49,"partly-cloudy-night",52,""
"327","11/13/17 14:00",936,394,542,"partly-cloudy-day",46,""
"328","10/13/17 0:00",47,29,18,"clear-night",55,""
"329","12/7/17 5:00",26,11,15,"clear-night",36,""
"330","12/23/17 18:00",184,60,124,"partly-cloudy-night",47,""
"331","12/20/17 15:00",1607,842,765,"clear-day",43,""
"332","12/8/17 18:00",433,210,223,"partly-cloudy-night",36,""
"333","12/8/17 13:00",1721,722,999,"clear-day",37,""
"334","12/20/17 1:00",19,15,4,"clear-night",49,""
"335","1/29/18 6:00",70,32,38,"clear-night",41,""
"336","11/26/17 15:00",1862,855,1007,"clear-day",45,""
"337","12/6/17 17:00",727,403,324,"clear-night",41,""
"338","11/27/17 18:00",580,364,216,"clear-night",46,""
"339","10/13/17 13:00",2016,983,1033,"partly-cloudy-day",63,""
"340","12/26/17 18:00",619,307,312,"clear-night",25,""
"341","12/11/17 20:00",329,236,93,"clear-night",35,""
"342","12/1/17 11:00",1425,604,821,"clear-day",50,""
"343","10/14/17 8:00",555,372,183,"partly-cloudy-day",62,""
"344","12/30/17 13:00",1577,822,755,"partly-cloudy-day",20,""
"345","10/24/17 13:00",1413,419,994,"partly-cloudy-day",71,""
"346","11/26/17 22:00",72,22,50,"clear-night",37,""
"347","1/13/18 20:00",97,36,61,"clear-night",23,""
"348","1/9/18 0:00",11,2,9,"cloudy",30,""
"349","12/26/17 3:00",0,0,0,"clear-night",26,""
"350","1/26/18 17:00",811,368,443,"clear-day",35,""
"351","12/3/17 17:00",1022,433,589,"partly-cloudy-night",46,""
"352","12/21/17 23:00",140,129,11,"partly-cloudy-night",34,""
"353","1/26/18 11:00",662,351,311,"clear-day",32,""
"354","10/19/17 4:00",3,2,1,"clear-night",55,""
"355","12/15/17 3:00",1,0,1,"clear-night",20,""
"356","12/29/17 0:00",9,4,5,"clear-night",11,""
"357","10/2/17 13:00",1753,898,855,"clear-day",68,""
"358","12/19/17 8:00",276,110,166,"partly-cloudy-day",45,""
"359","12/3/17 6:00",53,42,11,"partly-cloudy-night",40,""
"360","11/22/17 17:00",837,400,437,"partly-cloudy-night",44,""
"361","12/10/17 23:00",62,30,32,"partly-cloudy-night",35,""
"362","1/14/18 11:00",726,385,341,"clear-day",19,""
"363","1/9/18 5:00",5,3,2,"partly-cloudy-night",29,""
"364","11/21/17 4:00",5,3,2,"clear-night",40,""
"365","12/7/17 15:00",1599,759,840,"clear-day",44,""
"366","12/1/17 18:00",593,328,265,"clear-night",45,""
"367","10/2/17 1:00",27,15,12,"clear-night",52,""
"368","11/22/17 6:00",46,22,24,"partly-cloudy-night",49,""
"369","1/28/18 13:00",657,319,338,"partly-cloudy-day",47,""
"370","12/18/17 15:00",1843,851,992,"partly-cloudy-day",45,""
"371","10/28/17 3:00",3,0,3,"clear-night",49,""
"372","2/1/18 5:00",10,7,3,"clear-night",32,""
"373","10/11/17 17:00",1713,820,893,"partly-cloudy-day",70,""
"374","1/19/18 14:00",1004,478,526,"clear-day",36,""
"375","10/17/17 5:00",10,6,4,"clear-night",42,""
"376","12/7/17 20:00",266,182,84,"clear-night",39,""
"377","10/3/17 4:00",8,3,5,"clear-night",51,""
"378","11/13/17 23:00",53,28,25,"clear-night",35,""
"379","11/28/17 17:00",787,394,393,"clear-night",53,""
"380","10/31/17 4:00",2,1,1,"clear-night",49,"Halloween"
"381","11/23/17 15:00",2298,1168,1130,"clear-day",43,"Thanksgiving Day"
"382","10/1/17 14:00",2463,1339,1124,"clear-day",65,""
"383","12/11/17 5:00",14,8,6,"partly-cloudy-night",34,""
"384","1/17/18 11:00",181,109,72,"partly-cloudy-day",33,""
"385","1/6/18 0:00",5,2,3,"clear-night",9,""
"386","1/30/18 12:00",524,222,302,"partly-cloudy-day",34,""
"387","2/4/18 5:00",1,0,1,"partly-cloudy-night",30,""
"388","10/24/17 18:00",1396,820,576,"partly-cloudy-night",68,""
"389","12/14/17 16:00",883,414,469,"clear-day",29,""
"390","11/29/17 14:00",1211,561,650,"clear-day",63,""
"391","1/22/18 23:00",24,19,5,"fog",39,""
"392","1/26/18 6:00",55,33,22,"clear-night",25,""
"393","12/22/17 17:00",970,480,490,"partly-cloudy-night",45,""
"394","12/24/17 23:00",22,9,13,"cloudy",36,"Christmas Eve"
"395","10/8/17 16:00",2531,1224,1307,"partly-cloudy-day",76,""
"396","1/21/18 10:00",656,391,265,"clear-day",44,""
"397","12/13/17 8:00",146,45,101,"clear-day",21,""
"398","12/9/17 4:00",9,4,5,"partly-cloudy-night",34,""
"399","11/24/17 2:00",8,7,1,"clear-night",32,"Black Friday"
"400","1/20/18 3:00",6,3,3,"clear-night",34,""
"401","10/30/17 23:00",47,22,25,"clear-night",50,""
"402","1/6/18 11:00",609,348,261,"clear-day",11,""
"403","11/2/17 17:00",2334,1338,996,"clear-day",69,""
"404","2/4/18 22:00",6,4,2,"rain",40,""
"405","1/3/18 13:00",1995,958,1037,"clear-day",26,""
"406","1/23/18 19:00",283,207,76,"partly-cloudy-night",50,""
"407","10/16/17 12:00",1667,880,787,"clear-day",56,""
"408","10/22/17 0:00",147,85,62,"clear-night",58,""
"409","12/17/17 23:00",48,19,29,"partly-cloudy-night",34,""
"410","10/5/17 14:00",1812,908,904,"partly-cloudy-day",80,""
"411","1/21/18 20:00",277,178,99,"partly-cloudy-night",43,""
"412","12/19/17 11:00",1257,603,654,"partly-cloudy-day",52,""
"413","1/13/18 5:00",6,4,2,"cloudy",51,""
"414","11/25/17 10:00",1516,886,630,"clear-day",47,""
"415","1/10/18 20:00",110,63,47,"partly-cloudy-night",37,""
"416","12/17/17 12:00",1441,674,767,"cloudy",35,""
"417","11/22/17 16:00",1516,692,824,"partly-cloudy-day",46,""
"418","1/1/18 9:00",174,107,67,"clear-day",8,"New Year's Day"
"419","10/25/17 11:00",1987,982,1005,"partly-cloudy-day",60,""
"420","11/25/17 3:00",16,6,10,"clear-night",37,""
"421","10/26/17 19:00",357,179,178,"clear-night",55,""
"422","11/4/17 22:00",210,98,112,"clear-night",52,""
"423","12/2/17 23:00",199,142,57,"clear-night",40,""
"424","1/3/18 18:00",661,340,321,"partly-cloudy-night",25,""
"425","11/8/17 5:00",28,17,11,"partly-cloudy-night",39,""
"426","10/30/17 6:00",18,10,8,"rain",51,""
"427","11/1/17 7:00",210,111,99,"clear-night",45,""
"428","11/3/17 10:00",1165,684,481,"clear-day",64,""
"429","10/6/17 5:00",16,11,5,"partly-cloudy-night",67,""
"430","10/15/17 8:00",399,205,194,"partly-cloudy-day",65,""
"431","1/20/18 18:00",608,307,301,"clear-night",46,""
"432","12/16/17 2:00",0,0,0,"clear-night",21,""
"433","11/24/17 17:00",1436,490,946,"clear-night",46,"Black Friday"
"434","11/23/17 7:00",119,47,72,"clear-day",30,"Thanksgiving Day"
"435","12/31/17 1:00",12,4,8,"clear-night",18,"New Year's Eve"
"436","12/5/17 17:00",479,294,185,"partly-cloudy-night",59,""
"437","11/30/17 15:00",1289,598,691,"partly-cloudy-day",49,""
"438","1/15/18 18:00",261,121,140,"clear-night",27,"Martin Luther King Jr. Day"
"439","1/12/18 16:00",353,228,125,"rain",57,""
"440","12/16/17 8:00",126,60,66,"clear-day",25,""
"441","1/29/18 17:00",611,334,277,"partly-cloudy-day",42,""
"442","11/8/17 22:00",86,56,30,"clear-night",43,""
"443","10/15/17 21:00",335,145,190,"cloudy",68,""
"444","11/19/17 15:00",2100,914,1186,"partly-cloudy-day",48,""
"445","12/23/17 0:00",32,24,8,"partly-cloudy-night",40,""
"446","1/11/18 18:00",328,202,126,"clear-night",45,""
"447","12/28/17 14:00",2020,918,1102,"clear-day",17,""
"448","10/9/17 4:00",6,3,3,"partly-cloudy-night",72,"Columbus Day (regional holiday)"
"449","11/30/17 22:00",172,132,40,"partly-cloudy-night",48,""
"450","11/14/17 3:00",7,3,4,"clear-night",34,""
"451","11/17/17 4:00",2,1,1,"partly-cloudy-night",42,""
"452","2/4/18 19:00",32,27,5,"rain",41,""
"453","11/9/17 13:00",1757,898,859,"partly-cloudy-day",52,""
"454","1/23/18 9:00",97,29,68,"rain",49,""
"455","1/16/18 3:00",10,6,4,"partly-cloudy-night",25,""
"456","1/7/18 4:00",1,0,1,"clear-night",5,""
"457","10/23/17 14:00",2280,1199,1081,"partly-cloudy-day",72,""
"458","10/20/17 4:00",6,2,4,"clear-night",57,""
"459","10/7/17 13:00",3191,1691,1500,"clear-day",78,""
"460","1/21/18 15:00",1881,859,1022,"clear-day",49,""
"461","12/4/17 9:00",640,375,265,"partly-cloudy-day",37,""
"462","1/9/18 20:00",77,61,16,"clear-night",36,""
"463","12/20/17 2:00",10,9,1,"clear-night",49,""
"464","11/4/17 1:00",19,8,11,"clear-night",51,""
"465","1/21/18 3:00",7,2,5,"clear-night",37,""
"466","11/7/17 14:00",1580,760,820,"partly-cloudy-day",47,""
"467","10/24/17 7:00",274,125,149,"partly-cloudy-night",70,""
"468","12/15/17 0:00",103,97,6,"clear-night",21,""
"469","1/22/18 1:00",8,3,5,"cloudy",43,""
"470","10/27/17 14:00",2743,1429,1314,"clear-day",61,""
"471","11/5/17 13:00",1034,500,534,"cloudy",57,"Daylight Saving Time ends"
"472","12/18/17 20:00",313,222,91,"partly-cloudy-night",44,""
"473","11/27/17 11:00",1224,582,642,"clear-day",47,""
"474","1/28/18 1:00",15,9,6,"partly-cloudy-night",51,""
"475","12/30/17 9:00",391,227,164,"partly-cloudy-day",19,""
"476","1/9/18 3:00",0,0,0,"clear-night",28,""
"477","11/15/17 7:00",176,70,106,"clear-day",36,""
"478","12/3/17 2:00",12,4,8,"clear-night",39,""
"479","10/8/17 21:00",453,171,282,"clear-night",74,""
"480","10/1/17 20:00",481,143,338,"clear-night",59,""
"481","11/17/17 19:00",257,143,114,"clear-night",41,""
"482","11/21/17 23:00",61,27,34,"clear-night",48,""
"483","12/25/17 9:00",479,330,149,"clear-day",36,"Christmas Day"
"484","1/15/18 8:00",65,29,36,"clear-day",19,"Martin Luther King Jr. Day"
"485","11/24/17 23:00",96,46,50,"clear-night",40,"Black Friday"
"486","12/11/17 0:00",19,7,12,"partly-cloudy-night",34,""
"487","10/18/17 13:00",1580,816,764,"clear-day",68,""
"488","11/6/17 6:00",92,55,37,"partly-cloudy-night",61,""
"489","12/18/17 18:00",606,372,234,"cloudy",43,""
"490","1/24/18 7:00",175,68,107,"cloudy",41,""
"491","12/1/17 15:00",1814,826,988,"clear-day",50,""
"492","10/2/17 22:00",155,79,76,"clear-night",58,""
"493","12/7/17 1:00",23,12,11,"partly-cloudy-night",38,""
"494","11/10/17 9:00",403,227,176,"clear-day",37,"Veterans Day observed"
"495","10/4/17 21:00",264,135,129,"clear-night",68,""
"496","1/7/18 21:00",36,11,25,"partly-cloudy-night",17,""
"497","10/26/17 6:00",76,50,26,"partly-cloudy-night",53,""
"498","11/26/17 3:00",5,2,3,"partly-cloudy-night",47,""
"499","12/5/17 12:00",931,457,474,"partly-cloudy-day",57,""
"500","11/12/17 5:00",11,6,5,"clear-night",28,""
"501","10/12/17 20:00",332,165,167,"clear-night",59,""
"502","11/2/17 2:00",6,2,4,"cloudy",59,""
"503","12/12/17 13:00",904,432,472,"partly-cloudy-day",46,""
"504","11/28/17 6:00",98,54,44,"clear-night",34,""
"505","11/6/17 17:00",713,371,342,"clear-night",63,""
"506","10/18/17 8:00",358,123,235,"clear-day",47,""
"507","11/16/17 11:00",800,384,416,"partly-cloudy-day",51,""
"508","1/18/18 19:00",234,196,38,"clear-night",28,""
"509","1/31/18 1:00",5,0,5,"clear-night",22,""
"510","10/14/17 13:00",3059,1706,1353,"partly-cloudy-day",68,""
"511","12/20/17 11:00",1143,566,577,"partly-cloudy-day",43,""
"512","10/7/17 8:00",378,225,153,"partly-cloudy-day",65,""
"513","12/5/17 8:00",241,96,145,"partly-cloudy-day",52,""
"514","2/3/18 14:00",1331,671,660,"clear-day",29,""
"515","1/14/18 0:00",12,6,6,"clear-night",18,""
"516","1/22/18 18:00",489,351,138,"partly-cloudy-night",42,""
"517","10/10/17 12:00",2088,1024,1064,"clear-day",76,""
"518","12/29/17 22:00",56,27,29,"clear-night",16,""
"519","12/24/17 8:00",183,84,99,"clear-day",36,"Christmas Eve"
"520","12/8/17 9:00",471,241,230,"clear-day",34,""
"521","10/13/17 1:00",17,10,7,"clear-night",54,""
"522","12/13/17 21:00",156,138,18,"partly-cloudy-night",26,""
"523","10/19/17 16:00",1923,953,970,"clear-day",70,""
"524","1/4/18 21:00",23,11,12,"partly-cloudy-night",22,""
"525","12/15/17 15:00",796,332,464,"partly-cloudy-day",26,""
"526","12/2/17 6:00",53,36,17,"clear-night",34,""
"527","10/3/17 9:00",616,341,275,"clear-day",59,""
"528","2/2/18 13:00",649,282,367,"partly-cloudy-day",26,""
"529","10/14/17 4:00",5,4,1,"partly-cloudy-night",61,""
"530","11/26/17 18:00",556,285,271,"clear-night",42,""
"531","12/21/17 19:00",368,264,104,"partly-cloudy-night",36,""
"532","10/4/17 6:00",106,68,38,"clear-night",51,""
"533","12/18/17 3:00",2,1,1,"partly-cloudy-night",34,""
"534","12/14/17 2:00",4,1,3,"partly-cloudy-night",23,""
"535","1/27/18 20:00",323,154,169,"clear-night",52,""
"536","1/8/18 12:00",727,330,397,"partly-cloudy-day",25,""
"537","1/14/18 13:00",1005,467,538,"clear-day",23,""
"538","11/15/17 20:00",284,199,85,"partly-cloudy-night",47,""
"539","10/11/17 21:00",143,80,63,"partly-cloudy-night",65,""
"540","11/21/17 8:00",355,129,226,"clear-day",41,""
"541","12/16/17 23:00",145,112,33,"partly-cloudy-night",34,""
"542","10/2/17 5:00",19,13,6,"clear-night",48,""
"543","1/26/18 21:00",85,53,32,"clear-night",32,""
"544","1/11/18 8:00",187,61,126,"partly-cloudy-day",38,""
"545","12/23/17 15:00",899,472,427,"partly-cloudy-day",45,""
"546","12/30/17 18:00",358,203,155,"clear-night",20,""
"547","1/1/18 14:00",2066,1125,941,"clear-day",17,"New Year's Day"
"548","10/10/17 0:00",29,12,17,"partly-cloudy-night",74,""
"549","12/2/17 1:00",47,38,9,"clear-night",37,""
"550","1/31/18 22:00",61,48,13,"clear-night",30,""
"551","1/2/18 5:00",1,0,1,"clear-night",13,""
"552","11/28/17 23:00",43,21,22,"clear-night",48,""
"553","10/20/17 19:00",567,218,349,"clear-night",67,""
"554","11/8/17 12:00",1473,714,759,"partly-cloudy-day",46,""
"555","1/18/18 0:00",4,1,3,"partly-cloudy-night",21,""
"556","12/21/17 2:00",6,5,1,"clear-night",31,""
"557","10/21/17 12:00",3022,1533,1489,"clear-day",72,""
"558","10/7/17 20:00",665,213,452,"clear-night",72,""
"559","12/1/17 1:00",11,7,4,"partly-cloudy-night",47,""
"560","11/24/17 6:00",44,24,20,"clear-night",30,"Black Friday"
"561","11/1/17 12:00",1499,720,779,"cloudy",53,""
"562","12/9/17 8:00",170,70,100,"partly-cloudy-day",34,""
"563","1/25/18 10:00",370,200,170,"clear-day",27,""
"564","1/5/18 20:00",41,19,22,"clear-night",13,""
"565","12/11/17 10:00",757,414,343,"clear-day",36,""
"566","12/24/17 11:00",1802,906,896,"clear-day",38,"Christmas Eve"
"567","11/2/17 21:00",240,139,101,"clear-night",65,""
"568","12/27/17 17:00",1296,553,743,"clear-night",22,""
"569","12/15/17 11:00",826,386,440,"clear-day",25,""
"570","10/8/17 11:00",882,335,547,"partly-cloudy-day",72,""
"571","11/30/17 10:00",635,327,308,"clear-day",40,""
"572","12/27/17 2:00",1,0,1,"clear-night",20,""
"573","10/25/17 15:00",2217,1121,1096,"partly-cloudy-day",64,""
"574","11/27/17 5:00",18,8,10,"clear-night",38,""
"575","2/2/18 20:00",47,35,12,"clear-night",19,""
"576","10/19/17 11:00",1738,931,807,"clear-day",63,""
"577","12/19/17 15:00",1818,864,954,"clear-day",54,""
"578","1/24/18 22:00",36,26,10,"clear-night",28,""
"579","11/13/17 8:00",120,51,69,"partly-cloudy-day",42,""
"580","11/16/17 5:00",5,4,1,"partly-cloudy-night",51,""
"581","1/29/18 13:00",871,404,467,"partly-cloudy-day",42,""
"582","12/8/17 0:00",31,20,11,"partly-cloudy-night",38,""
"583","10/14/17 9:00",1503,1300,203,"partly-cloudy-day",62,""
"584","1/11/18 21:00",102,73,29,"clear-night",41,""
"585","10/16/17 16:00",1723,889,834,"clear-day",57,""
"586","1/3/18 3:00",8,4,4,"clear-night",15,""
"587","1/19/18 10:00",374,211,163,"clear-day",29,""
"588","11/29/17 2:00",7,5,2,"clear-night",48,""
"589","1/11/18 3:00",2,1,1,"partly-cloudy-night",36,""
"590","1/2/18 4:00",1,0,1,"clear-night",13,""
"591","10/26/17 23:00",64,38,26,"clear-night",50,""
"592","11/25/17 14:00",3195,1380,1815,"clear-day",56,""
"593","10/9/17 19:00",368,175,193,"partly-cloudy-night",74,"Columbus Day (regional holiday)"
"594","10/27/17 22:00",193,89,104,"clear-night",53,""
"595","10/11/17 13:00",1572,770,802,"clear-day",72,""
"596","1/29/18 0:00",31,14,17,"clear-night",43,""
"597","12/10/17 2:00",8,6,2,"partly-cloudy-night",31,""
"598","10/21/17 5:00",21,16,5,"clear-night",53,""
"599","11/17/17 8:00",306,128,178,"clear-day",40,""
"600","11/4/17 18:00",1187,488,699,"clear-night",53,""
"601","12/17/17 10:00",811,452,359,"cloudy",34,""
"602","12/17/17 16:00",1735,728,1007,"clear-day",36,""
"603","12/28/17 10:00",1222,710,512,"clear-day",14,""
"604","10/5/17 10:00",1081,640,441,"clear-day",69,""
"605","10/10/17 22:00",141,65,76,"clear-night",68,""
"606","12/16/17 4:00",1,0,1,"clear-night",23,""
"607","1/30/18 21:00",55,33,22,"partly-cloudy-night",27,""
"608","12/22/17 10:00",657,359,298,"partly-cloudy-day",38,""
"609","10/6/17 1:00",22,11,11,"partly-cloudy-night",69,""
"610","10/22/17 10:00",2355,1392,963,"clear-day",59,""
"611","11/17/17 23:00",139,81,58,"clear-night",36,""
"612","11/9/17 1:00",5,4,1,"clear-night",40,""
"613","1/4/18 11:00",71,36,35,"snow",23,""
"614","11/27/17 15:00",1263,595,668,"clear-day",51,""
"615","11/12/17 12:00",1973,905,1068,"partly-cloudy-day",42,""
"616","10/15/17 12:00",2420,1356,1064,"partly-cloudy-day",69,""
"617","10/24/17 22:00",121,57,64,"partly-cloudy-night",67,""
"618","1/2/18 22:00",56,30,26,"clear-night",18,""
"619","12/9/17 21:00",59,38,21,"partly-cloudy-night",31,""
"620","1/14/18 20:00",120,86,34,"clear-night",19,""
"621","12/24/17 18:00",674,361,313,"partly-cloudy-night",38,"Christmas Eve"
"622","12/21/17 16:00",1739,791,948,"clear-day",39,""
"623","1/15/18 11:00",674,340,334,"partly-cloudy-day",26,"Martin Luther King Jr. Day"
"624","11/3/17 14:00",2369,1181,1188,"partly-cloudy-day",71,""
"625","10/4/17 12:00",1709,899,810,"clear-day",68,""
"626","12/5/17 21:00",43,39,4,"rain",57,""
"627","10/15/17 17:00",2298,1033,1265,"cloudy",71,""
"628","1/6/18 7:00",34,21,13,"clear-night",7,""
"629","11/10/17 6:00",71,42,29,"partly-cloudy-night",42,"Veterans Day observed"
"630","1/24/18 17:00",626,322,304,"partly-cloudy-night",34,""
"631","11/19/17 7:00",56,36,20,"partly-cloudy-day",57,""
"632","11/23/17 11:00",1076,552,524,"clear-day",38,"Thanksgiving Day"
"633","12/26/17 9:00",364,221,143,"clear-day",24,""
"634","11/13/17 19:00",322,220,102,"clear-night",41,""
"635","11/4/17 5:00",10,9,1,"clear-night",48,""
"636","12/24/17 1:00",17,9,8,"clear-night",39,"Christmas Eve"
"637","11/7/17 17:00",23,13,10,"rain",41,""
"638","10/21/17 0:00",84,48,36,"clear-night",59,""
"639","10/26/17 2:00",4,2,2,"partly-cloudy-night",55,""
"640","1/13/18 12:00",1254,604,650,"partly-cloudy-day",31,""
"641","11/10/17 21:00",116,70,46,"clear-night",26,"Veterans Day observed"
"642","11/1/17 22:00",108,67,41,"partly-cloudy-night",57,""
"643","2/1/18 12:00",642,304,338,"partly-cloudy-day",39,""
"644","10/7/17 3:00",10,5,5,"clear-night",66,""
"645","12/16/17 19:00",296,175,121,"cloudy",37,""
"646","12/25/17 18:00",547,234,313,"clear-night",31,"Christmas Day"
"647","11/18/17 17:00",378,189,189,"partly-cloudy-night",48,""
"648","10/17/17 13:00",1543,786,757,"clear-day",54,""
"649","10/29/17 15:00",82,37,45,"rain",64,""
"650","1/7/18 15:00",943,458,485,"clear-day",18,""
"651","1/10/18 13:00",885,400,485,"clear-day",38,""
"652","12/20/17 8:00",254,89,165,"clear-day",42,""
"653","11/27/17 9:00",485,284,201,"clear-day",43,""
"654","10/12/17 16:00",1780,957,823,"partly-cloudy-day",63,""
"655","1/18/18 2:00",2,1,1,"clear-night",20,""
"656","1/27/18 1:00",17,9,8,"clear-night",32,""
"657","1/4/18 1:00",53,51,2,"partly-cloudy-night",26,""
"658","1/28/18 5:00",1,0,1,"partly-cloudy-night",48,""
"659","11/20/17 15:00",1650,794,856,"clear-day",46,""
"660","10/3/17 13:00",1572,792,780,"partly-cloudy-day",67,""
"661","10/27/17 10:00",1650,994,656,"clear-day",51,""
"662","12/19/17 0:00",40,25,15,"partly-cloudy-night",43,""
"663","11/6/17 13:00",1424,659,765,"partly-cloudy-day",64,""
"664","10/29/17 20:00",9,5,4,"rain",64,""
"665","12/31/17 6:00",7,5,2,"clear-night",16,"New Year's Eve"
"666","10/31/17 14:00",2398,1137,1261,"clear-day",56,"Halloween"
"667","10/10/17 5:00",24,16,8,"clear-night",67,""
"668","11/30/17 7:00",172,74,98,"clear-night",36,""
"669","1/12/18 11:00",308,187,121,"cloudy",58,""
"670","10/13/17 5:00",17,11,6,"partly-cloudy-night",52,""
"671","11/9/17 20:00",344,0,0,"partly-cloudy-night",51,""
"672","11/6/17 2:00",1,1,0,"partly-cloudy-night",59,""
"673","12/18/17 14:00",1826,773,1053,"partly-cloudy-day",44,""
"674","1/14/18 3:00",0,0,0,"clear-night",16,""
"675","12/14/17 20:00",115,82,33,"clear-night",25,""
"676","11/14/17 16:00",1116,518,598,"cloudy",44,""
"677","2/4/18 12:00",934,421,513,"partly-cloudy-day",39,""
"678","1/14/18 10:00",571,333,238,"clear-day",18,""
"679","10/19/17 21:00",264,134,130,"clear-night",64,""
"680","11/16/17 15:00",1035,479,556,"partly-cloudy-day",52,""
"681","10/6/17 12:00",1941,1049,892,"clear-day",76,""
"682","12/7/17 14:00",1545,608,937,"clear-day",44,""
"683","1/10/18 0:00",8,1,7,"clear-night",30,""
"684","11/2/17 6:00",62,38,24,"partly-cloudy-night",60,""
"685","1/7/18 19:00",119,60,59,"clear-night",17,""
"686","2/2/18 3:00",0,0,0,"rain",37,""
"687","11/28/17 2:00",2,1,1,"clear-night",35,""
"688","1/24/18 12:00",818,357,461,"partly-cloudy-day",40,""
"689","10/17/17 12:00",1668,863,805,"clear-day",52,""
"690","12/3/17 14:00",1869,746,1123,"partly-cloudy-day",47,""
"691","12/29/17 1:00",8,6,2,"clear-night",11,""
"692","10/4/17 17:00",1907,1135,772,"clear-day",74,""
"693","11/26/17 7:00",170,84,86,"clear-night",43,""
"694","10/6/17 13:00",1862,906,956,"clear-day",78,""
"695","10/28/17 12:00",3486,1925,1561,"clear-day",66,""
"696","12/23/17 10:00",241,132,109,"rain",40,""
"697","11/11/17 14:00",2209,987,1222,"clear-day",37,"Veterans Day"
"698","1/26/18 1:00",7,6,1,"partly-cloudy-night",27,""
"699","1/2/18 10:00",1004,626,378,"clear-day",16,""
"700","10/18/17 3:00",5,3,2,"clear-night",48,""
"701","11/26/17 1:00",21,11,10,"partly-cloudy-night",49,""
"702","11/11/17 4:00",1,0,1,"clear-night",24,"Veterans Day"
"703","1/25/18 15:00",712,324,388,"clear-day",34,""
"704","1/4/18 6:00",13,5,8,"partly-cloudy-night",25,""
"705","1/18/18 23:00",30,18,12,"clear-night",25,""
"706","11/29/17 17:00",773,393,380,"clear-night",55,""
"707","10/5/17 20:00",393,180,213,"partly-cloudy-night",76,""
"708","12/27/17 15:00",2588,1399,1189,"clear-day",24,""
"709","1/23/18 14:00",484,259,225,"partly-cloudy-day",57,""
"710","10/11/17 3:00",8,6,2,"clear-night",63,""
"711","11/28/17 13:00",1193,478,715,"clear-day",49,""
"712","12/20/17 23:00",116,84,32,"clear-night",34,""
"713","10/18/17 20:00",353,184,169,"clear-night",62,""
"714","11/20/17 1:00",7,3,4,"partly-cloudy-night",39,""
"715","1/25/18 20:00",83,50,33,"clear-night",30,""
"716","2/1/18 13:00",845,366,479,"clear-day",40,""
"717","10/1/17 1:00",30,17,13,"partly-cloudy-night",53,""
"718","12/6/17 16:00",1186,579,607,"clear-day",42,""
"719","11/16/17 0:00",36,20,16,"partly-cloudy-night",49,""
"720","12/10/17 17:00",539,221,318,"partly-cloudy-night",36,""
"721","11/21/17 18:00",800,462,338,"clear-night",51,""
"722","10/12/17 1:00",15,7,8,"partly-cloudy-night",63,""
"723","11/5/17 9:00",700,468,232,"partly-cloudy-day",55,"Daylight Saving Time ends"
"724","1/8/18 16:00",577,261,316,"partly-cloudy-day",30,""
"725","12/29/17 18:00",564,247,317,"clear-night",19,""
"726","12/3/17 9:00",710,431,279,"partly-cloudy-day",43,""
"727","10/22/17 3:00",25,16,9,"clear-night",56,""
"728","10/22/17 23:00",105,54,51,"clear-night",58,""
"729","10/14/17 0:00",65,24,41,"partly-cloudy-night",62,""
"730","10/4/17 2:00",11,7,4,"clear-night",53,""
"731","1/22/18 6:00",45,20,25,"partly-cloudy-night",40,""
"732","12/31/17 21:00",172,94,78,"clear-night",10,"New Year's Eve"
"733","12/10/17 16:00",1775,832,943,"partly-cloudy-day",37,""
"734","10/9/17 14:00",654,339,315,"rain",72,"Columbus Day (regional holiday)"
"735","1/16/18 18:00",325,244,81,"partly-cloudy-night",34,""
"736","2/2/18 6:00",27,19,8,"partly-cloudy-night",32,""
"737","1/29/18 4:00",2,0,2,"clear-night",41,""
"738","12/22/17 7:00",102,49,53,"partly-cloudy-night",35,""
"739","12/5/17 4:00",5,4,1,"partly-cloudy-night",50,""
"740","1/24/18 2:00",3,1,2,"clear-night",41,""
"741","12/17/17 15:00",1995,983,1012,"clear-day",37,""
"742","2/1/18 2:00",1,0,1,"clear-night",31,""
"743","10/13/17 19:00",700,311,389,"partly-cloudy-night",63,""
"744","12/8/17 19:00",289,140,149,"partly-cloudy-night",36,""
"745","11/14/17 18:00",540,345,195,"partly-cloudy-night",42,""
"746","12/6/17 20:00",294,225,69,"clear-night",40,""
"747","1/30/18 18:00",332,255,77,"partly-cloudy-night",30,""
"748","12/23/17 19:00",60,36,24,"rain",46,""
"749","10/13/17 4:00",10,6,4,"partly-cloudy-night",52,""
"750","2/3/18 11:00",828,439,389,"clear-day",26,""
"751","11/20/17 6:00",89,51,38,"partly-cloudy-night",36,""
"752","10/10/17 17:00",1913,1162,751,"clear-day",79,""
"753","10/19/17 20:00",353,176,177,"clear-night",65,""
"754","10/1/17 6:00",113,88,25,"partly-cloudy-night",49,""
"755","11/8/17 8:00",353,123,230,"partly-cloudy-day",39,""
"756","10/11/17 8:00",437,149,288,"clear-day",64,""
"757","10/3/17 12:00",1666,852,814,"clear-day",67,""
"758","10/16/17 20:00",225,97,128,"clear-night",53,""
"759","10/5/17 21:00",287,125,162,"clear-night",75,""
"760","10/22/17 8:00",387,214,173,"clear-day",54,""
"761","11/9/17 6:00",113,82,31,"clear-night",38,""
"762","10/19/17 7:00",304,144,160,"clear-night",53,""
"763","1/30/18 6:00",11,8,3,"partly-cloudy-night",30,""
"764","12/31/17 20:00",184,94,90,"clear-night",11,"New Year's Eve"
"765","10/29/17 6:00",6,4,2,"partly-cloudy-night",60,""
"766","1/12/18 1:00",5,3,2,"partly-cloudy-night",44,""
"767","10/12/17 6:00",59,33,26,"partly-cloudy-night",58,""
"768","10/23/17 1:00",16,9,7,"clear-night",57,""
"769","12/10/17 11:00",1767,866,901,"clear-day",35,""
"770","1/16/18 6:00",36,14,22,"cloudy",26,""
"771","11/29/17 22:00",85,55,30,"clear-night",43,""
"772","10/28/17 13:00",4055,1560,2495,"clear-day",67,""
"773","10/23/17 18:00",1075,573,502,"partly-cloudy-day",68,""
"774","11/3/17 1:00",18,10,8,"clear-night",61,""
"775","1/19/18 6:00",46,24,22,"clear-night",22,""
"776","11/8/17 13:00",1485,719,766,"partly-cloudy-day",47,""
"777","10/4/17 13:00",1611,811,800,"clear-day",71,""
"778","11/24/17 10:00",1176,625,551,"clear-day",41,"Black Friday"
"779","10/9/17 9:00",477,254,223,"partly-cloudy-day",72,"Columbus Day (regional holiday)"
"780","11/19/17 23:00",38,20,18,"partly-cloudy-night",40,""
"781","1/7/18 12:00",601,331,270,"clear-day",13,""
"782","12/30/17 4:00",0,0,0,"partly-cloudy-night",16,""
"783","11/18/17 1:00",37,26,11,"clear-night",34,""
"784","11/1/17 17:00",1474,780,694,"partly-cloudy-day",56,""
"785","12/28/17 6:00",16,15,1,"clear-night",14,""
"786","11/3/17 18:00",878,372,506,"partly-cloudy-night",70,""
"787","11/25/17 18:00",1014,363,651,"partly-cloudy-night",54,""
"788","10/16/17 21:00",133,59,74,"clear-night",51,""
"789","12/25/17 7:00",50,29,21,"rain",34,"Christmas Day"
"790","12/1/17 6:00",100,64,36,"clear-night",43,""
"791","12/19/17 19:00",398,273,125,"clear-night",51,""
"792","12/11/17 4:00",6,4,2,"partly-cloudy-night",34,""
"793","12/27/17 5:00",6,2,4,"cloudy",19,""
"794","12/14/17 7:00",77,26,51,"fog",25,""
"795","1/23/18 1:00",5,4,1,"fog",38,""
"796","10/10/17 4:00",8,6,2,"clear-night",68,""
"797","10/16/17 6:00",58,34,24,"partly-cloudy-night",61,""
"798","11/24/17 15:00",2913,1311,1602,"clear-day",50,"Black Friday"
"799","10/23/17 6:00",83,44,39,"partly-cloudy-night",60,""
"800","1/2/18 0:00",15,2,13,"clear-night",14,""
"801","1/4/18 16:00",258,155,103,"snow",27,""
"802","1/5/18 3:00",0,0,0,"clear-night",13,""
"803","1/19/18 1:00",12,9,3,"clear-night",23,""
"804","10/5/17 6:00",101,54,47,"partly-cloudy-night",63,""
"805","12/26/17 19:00",332,158,174,"clear-night",24,""
"806","11/14/17 11:00",1022,414,608,"partly-cloudy-day",42,""
"807","12/12/17 8:00",256,77,179,"partly-cloudy-day",45,""
"808","1/13/18 0:00",43,30,13,"cloudy",56,""
"809","1/18/18 5:00",11,4,7,"clear-night",18,""
"810","1/25/18 6:00",40,18,22,"clear-night",23,""
"811","1/19/18 20:00",104,60,44,"clear-night",34,""
"812","12/13/17 16:00",744,340,404,"clear-day",30,""
"813","1/30/18 1:00",0,0,0,"partly-cloudy-night",32,""
"814","10/30/17 18:00",1084,491,593,"clear-night",53,""
"815","12/17/17 20:00",325,223,102,"partly-cloudy-night",35,""
"816","1/8/18 6:00",27,12,15,"clear-night",18,""
"817","12/25/17 21:00",90,47,43,"clear-night",28,"Christmas Day"
"818","1/24/18 13:00",796,359,437,"partly-cloudy-day",40,""
"819","12/23/17 8:00",62,32,30,"rain",39,""
"820","12/8/17 4:00",2,0,2,"clear-night",35,""
"821","11/13/17 15:00",983,467,516,"partly-cloudy-day",47,""
"822","12/12/17 2:00",18,8,10,"partly-cloudy-night",38,""
"823","11/3/17 6:00",84,47,37,"clear-night",60,""
"824","2/4/18 13:00",722,367,355,"partly-cloudy-day",38,""
"825","11/14/17 1:00",7,2,5,"clear-night",35,""
"826","11/18/17 11:00",1581,735,846,"clear-day",43,""
"827","11/23/17 2:00",3,1,2,"clear-night",33,"Thanksgiving Day"
"828","1/10/18 17:00",456,207,249,"partly-cloudy-night",36,""
"829","1/20/18 9:00",321,202,119,"clear-day",40,""
"830","1/16/18 21:00",61,32,29,"partly-cloudy-night",33,""
"831","10/14/17 22:00",283,143,140,"partly-cloudy-night",67,""
"832","1/21/18 17:00",1015,372,643,"partly-cloudy-night",47,""
"833","1/3/18 8:00",194,91,103,"clear-day",14,""
"834","1/9/18 9:00",311,186,125,"clear-day",32,""
"835","11/27/17 19:00",329,234,95,"clear-night",44,""
"836","12/19/17 4:00",6,4,2,"cloudy",44,""
"837","12/11/17 19:00",433,335,98,"clear-night",36,""
"838","11/7/17 22:00",6,4,2,"rain",40,""
"839","11/9/17 21:00",300,187,113,"partly-cloudy-night",51,""
"840","11/20/17 23:00",69,39,30,"clear-night",41,""
"841","11/7/17 6:00",143,80,63,"clear-night",41,""
"842","11/1/17 2:00",3,2,1,"clear-night",45,""
"843","11/15/17 11:00",1050,494,556,"clear-day",45,""
"844","1/17/18 9:00",82,31,51,"snow",33,""
"845","1/10/18 4:00",2,0,2,"clear-night",26,""
"846","1/22/18 21:00",80,55,25,"partly-cloudy-night",40,""
"847","11/4/17 9:00",734,453,281,"clear-day",49,""
"848","11/25/17 23:00",224,144,80,"partly-cloudy-night",49,""
"849","1/15/18 16:00",955,407,548,"clear-day",30,"Martin Luther King Jr. Day"
"850","1/25/18 21:00",102,83,19,"clear-night",29,""
"851","1/2/18 17:00",1207,473,734,"clear-night",24,""
"852","11/12/17 13:00",1926,809,1117,"clear-day",45,""
"853","11/2/17 10:00",1447,921,526,"partly-cloudy-day",61,""
"854","11/13/17 10:00",280,145,135,"partly-cloudy-day",41,""
"855","11/9/17 16:00",1532,774,758,"partly-cloudy-day",52,""
"856","1/14/18 21:00",52,26,26,"clear-night",18,""
"857","12/3/17 7:00",175,97,78,"partly-cloudy-night",41,""
"858","1/17/18 4:00",3,1,2,"cloudy",35,""
"859","11/26/17 11:00",1444,722,722,"partly-cloudy-day",45,""
"860","12/5/17 20:00",47,38,9,"rain",57,""
"861","1/3/18 21:00",89,40,49,"clear-night",26,""
"862","11/22/17 7:00",84,38,46,"partly-cloudy-day",49,""
"863","10/13/17 14:00",2340,1085,1255,"partly-cloudy-day",64,""
"864","10/11/17 20:00",242,122,120,"partly-cloudy-night",66,""
"865","11/16/17 19:00",364,232,132,"clear-night",48,""
"866","11/5/17 22:00",73,34,39,"cloudy",59,"Daylight Saving Time ends"
"867","10/15/17 13:00",2649,1426,1223,"partly-cloudy-day",71,""
"868","12/5/17 10:00",540,274,266,"partly-cloudy-day",54,""
"869","11/18/17 22:00",181,121,60,"rain",49,""
"870","10/2/17 4:00",2,0,2,"clear-night",49,""
"871","12/9/17 20:00",59,40,19,"partly-cloudy-night",31,""
"872","12/28/17 21:00",59,26,33,"clear-night",13,""
"873","10/2/17 14:00",1719,885,834,"clear-day",69,""
"874","11/20/17 17:00",952,437,515,"clear-night",44,""
"875","10/25/17 22:00",158,96,62,"clear-night",59,""
"876","12/29/17 11:00",1838,939,899,"clear-day",17,""
"877","10/7/17 16:00",3388,1644,1744,"clear-day",77,""
"878","2/3/18 22:00",42,27,15,"partly-cloudy-night",28,""
"879","12/2/17 14:00",2733,1208,1525,"clear-day",47,""
"880","12/12/17 23:00",23,8,15,"partly-cloudy-night",31,""
"881","11/4/17 4:00",7,5,2,"clear-night",48,""
"882","10/24/17 9:00",677,378,299,"partly-cloudy-day",69,""
"883","12/9/17 10:00",821,396,425,"partly-cloudy-day",33,""
"884","10/17/17 8:00",291,91,200,"clear-day",41,""
"885","12/1/17 23:00",141,113,28,"clear-night",39,""
"886","10/13/17 9:00",500,271,229,"partly-cloudy-day",55,""
"887","10/3/17 22:00",134,65,69,"clear-night",56,""
"888","2/1/18 17:00",593,339,254,"partly-cloudy-day",42,""
"889","10/18/17 16:00",1861,1062,799,"clear-day",72,""
"890","10/9/17 0:00",112,38,74,"clear-night",73,"Columbus Day (regional holiday)"
"891","10/17/17 23:00",46,27,19,"clear-night",51,""
"892","10/29/17 21:00",2,1,1,"rain",63,""
"893","10/27/17 6:00",91,54,37,"clear-night",44,""
"894","1/31/18 9:00",169,82,87,"clear-day",20,""
"895","1/17/18 14:00",326,176,150,"snow",33,""
"896","10/18/17 21:00",223,112,111,"clear-night",60,""
"897","12/16/17 0:00",10,8,2,"clear-night",22,""
"898","10/12/17 11:00",1239,762,477,"partly-cloudy-day",58,""
"899","11/2/17 20:00",316,141,175,"partly-cloudy-night",66,""
"900","10/1/17 21:00",275,117,158,"clear-night",57,""
"901","12/7/17 11:00",1333,612,721,"clear-day",42,""
"902","12/29/17 14:00",2305,1254,1051,"partly-cloudy-day",21,""
"903","11/27/17 2:00",3,0,3,"clear-night",38,""
"904","10/6/17 17:00",2124,1188,936,"clear-day",77,""
"905","12/24/17 16:00",2487,1282,1205,"clear-day",39,"Christmas Eve"
"906","10/7/17 21:00",373,150,223,"clear-night",71,""
"907","2/2/18 10:00",321,183,138,"clear-day",27,""
"908","11/3/17 23:00",87,46,41,"clear-night",54,""
"909","12/28/17 20:00",143,64,79,"clear-night",14,""
"910","1/29/18 10:00",487,281,206,"clear-day",41,""
"911","1/9/18 14:00",1109,513,596,"clear-day",43,""
"912","10/31/17 9:00",796,411,385,"clear-day",49,"Halloween"
"913","1/14/18 8:00",85,48,37,"clear-day",15,""
"914","1/8/18 20:00",83,32,51,"cloudy",29,""
"915","10/2/17 9:00",536,293,243,"clear-day",56,""
"916","11/21/17 14:00",1966,808,1158,"clear-day",57,""
"917","12/23/17 23:00",115,89,26,"partly-cloudy-night",42,""
"918","12/18/17 11:00",1210,643,567,"cloudy",39,""
"919","12/5/17 0:00",13,8,5,"partly-cloudy-night",48,""
"920","2/1/18 6:00",56,28,28,"partly-cloudy-night",33,""
"921","10/4/17 20:00",395,150,245,"clear-night",69,""
"922","11/29/17 7:00",208,85,123,"clear-night",46,""
"923","11/8/17 4:00",5,3,2,"partly-cloudy-night",39,""
"924","10/20/17 11:00",1994,1023,971,"clear-day",66,""
"925","1/10/18 21:00",60,37,23,"partly-cloudy-night",37,""
"926","1/11/18 16:00",1080,511,569,"partly-cloudy-day",46,""
"927","12/20/17 18:00",394,235,159,"clear-night",39,""
"928","10/10/17 13:00",2105,1007,1098,"clear-day",77,""
"929","11/5/17 7:00",173,104,69,"cloudy",53,"Daylight Saving Time ends"
"930","1/23/18 22:00",60,37,23,"clear-night",44,""
"931","10/24/17 14:00",1217,636,581,"partly-cloudy-day",70,""
"932","10/21/17 4:00",14,9,5,"clear-night",53,""
"933","1/28/18 17:00",697,324,373,"partly-cloudy-day",47,""
"934","11/13/17 0:00",29,15,14,"clear-night",39,""
"935","10/11/17 12:00",1576,758,818,"clear-day",71,""
"936","12/16/17 13:00",1932,815,1117,"partly-cloudy-day",36,""
"937","12/6/17 18:00",561,394,167,"clear-night",41,""
"938","10/9/17 5:00",9,5,4,"partly-cloudy-night",72,"Columbus Day (regional holiday)"
"939","10/16/17 1:00",11,3,8,"partly-cloudy-night",68,""
"940","11/26/17 21:00",146,66,80,"clear-night",37,""
"941","1/18/18 12:00",681,299,382,"clear-day",28,""
"942","10/3/17 17:00",1695,996,699,"clear-day",66,""
"943","1/20/18 6:00",20,10,10,"clear-night",35,""
"944","12/20/17 0:00",125,105,20,"clear-night",48,""
"945","10/27/17 1:00",17,11,6,"clear-night",47,""
"946","1/10/18 9:00",260,145,115,"clear-day",30,""
"947","1/12/18 5:00",8,6,2,"fog",46,""
"948","12/22/17 0:00",187,176,11,"partly-cloudy-night",34,""
"949","1/15/18 21:00",43,21,22,"clear-night",25,"Martin Luther King Jr. Day"
"950","11/6/17 15:00",1345,713,632,"rain",64,""
"951","11/5/17 12:00",1242,549,693,"cloudy",57,"Daylight Saving Time ends"
"952","1/19/18 23:00",102,66,36,"clear-night",33,""
"953","12/4/17 19:00",409,257,152,"partly-cloudy-night",46,""
"954","1/6/18 4:00",0,0,0,"clear-night",8,""
"955","1/26/18 18:00",329,209,120,"clear-night",33,""
"956","10/19/17 3:00",7,4,3,"clear-night",57,""
"957","1/26/18 12:00",855,379,476,"clear-day",33,""
"958","10/5/17 1:00",21,10,11,"clear-night",64,""
"959","10/14/17 17:00",2585,1253,1332,"partly-cloudy-day",70,""
"960","11/19/17 2:00",15,9,6,"partly-cloudy-night",54,""
"961","1/28/18 16:00",1042,514,528,"partly-cloudy-day",49,""
"962","12/21/17 7:00",145,71,74,"clear-night",31,""
"963","12/18/17 16:00",1604,702,902,"partly-cloudy-day",44,""
"964","11/24/17 0:00",31,9,22,"clear-night",33,"Black Friday"
"965","10/28/17 17:00",3451,1587,1864,"clear-day",65,""
"966","12/10/17 7:00",78,41,37,"clear-night",28,""
"967","11/30/17 17:00",844,411,433,"clear-night",47,""
"968","12/26/17 4:00",2,0,2,"clear-night",25,""
"969","12/15/17 19:00",77,44,33,"partly-cloudy-night",24,""
"970","12/7/17 16:00",1579,736,843,"clear-day",43,""
"971","10/25/17 7:00",324,170,154,"clear-night",57,""
"972","12/31/17 16:00",1589,741,848,"clear-day",14,"New Year's Eve"
"973","1/17/18 17:00",259,184,75,"partly-cloudy-night",29,""
"974","10/22/17 18:00",1536,566,970,"clear-day",62,""
"975","11/4/17 14:00",2991,1529,1462,"partly-cloudy-day",54,""
"976","11/7/17 1:00",4,2,2,"clear-night",45,""
"977","12/30/17 19:00",204,128,76,"clear-night",20,""
"978","11/18/17 7:00",89,34,55,"clear-day",32,""
"979","10/20/17 5:00",26,13,13,"clear-night",55,""
"980","12/16/17 12:00",1654,782,872,"partly-cloudy-day",34,""
"981","12/14/17 11:00",687,322,365,"partly-cloudy-day",28,""
"982","12/30/17 21:00",126,48,78,"clear-night",20,""
"983","10/21/17 13:00",3209,1666,1543,"clear-day",76,""
"984","11/20/17 10:00",1025,583,442,"partly-cloudy-day",40,""
"985","12/9/17 0:00",105,84,21,"partly-cloudy-night",35,""
"986","11/14/17 23:00",68,24,44,"partly-cloudy-night",37,""
"987","11/12/17 19:00",380,203,177,"clear-night",40,""
"988","1/5/18 23:00",14,7,7,"clear-night",10,""
"989","1/1/18 5:00",2,1,1,"clear-night",7,"New Year's Day"
"990","11/1/17 13:00",1621,744,877,"partly-cloudy-day",54,""
"991","2/4/18 4:00",1,0,1,"cloudy",30,""
"992","1/6/18 17:00",280,118,162,"clear-night",11,""
"993","10/29/17 10:00",598,340,258,"rain",61,""
"994","11/19/17 19:00",369,206,163,"partly-cloudy-night",45,""
"995","1/1/18 3:00",4,1,3,"clear-night",7,"New Year's Day"
"996","11/28/17 15:00",1231,560,671,"clear-day",51,""
"997","1/15/18 3:00",2,0,2,"clear-night",16,"Martin Luther King Jr. Day"
"998","1/6/18 16:00",651,342,309,"clear-day",12,""
"999","1/5/18 9:00",124,67,57,"clear-day",9,""
"1000","10/23/17 23:00",78,45,33,"partly-cloudy-night",68,""
